Piste 10,Piste 16,Piste 28,Piste 32,Piste 34,Total,company_name
0,18,154,100,11,283,Flughafen Zürich AG
0,22,198,38,3,261,Flughafen Zürich AG
0,12,116,68,11,207,Flughafen Zürich AG
0,22,171,17,8,218,Flughafen Zürich AG
0,18,211,18,6,253,Flughafen Zürich AG
0,9,171,87,16,283,Flughafen Zürich AG
0,20,174,75,13,282,Flughafen Zürich AG
0,16,172,96,11,295,Flughafen Zürich AG
0,15,215,12,8,250,Flughafen Zürich AG
0,16,161,9,6,192,Flughafen Zürich AG
0,15,176,11,11,213,Flughafen Zürich AG
0,21,197,17,7,242,Flughafen Zürich AG
0,18,234,14,14,280,Flughafen Zürich AG
0,22,197,46,10,275,Flughafen Zürich AG
0,30,202,59,12,303,Flughafen Zürich AG
0,0,40,211,11,262,Flughafen Zürich AG
0,32,112,41,5,190,Flughafen Zürich AG
0,7,108,93,3,211,Flughafen Zürich AG
0,16,208,15,6,245,Flughafen Zürich AG
0,18,226,20,7,271,Flughafen Zürich AG
0,23,177,52,20,272,Flughafen Zürich AG
0,5,139,132,13,289,Flughafen Zürich AG
0,16,224,14,7,261,Flughafen Zürich AG
143,14,8,8,6,179,Flughafen Zürich AG
0,16,181,14,5,216,Flughafen Zürich AG
0,2,90,145,8,245,Flughafen Zürich AG
0,24,218,24,6,272,Flughafen Zürich AG
0,25,171,58,5,259,Flughafen Zürich AG
0,17,112,136,9,274,Flughafen Zürich AG
0,17,203,16,4,240,Flughafen Zürich AG
0,23,169,8,2,202,Flughafen Zürich AG
0,1,102,115,7,225,Flughafen Zürich AG
0,17,211,14,8,250,Flughafen Zürich AG
0,24,169,47,3,243,Flughafen Zürich AG
0,11,137,90,13,251,Flughafen Zürich AG
0,16,186,17,5,224,Flughafen Zürich AG
0,3,78,69,12,162,Flughafen Zürich AG
0,8,152,14,4,178,Flughafen Zürich AG
0,19,178,16,3,216,Flughafen Zürich AG
0,16,213,13,9,251,Flughafen Zürich AG
0,33,153,63,4,253,Flughafen Zürich AG
0,20,173,47,28,268,Flughafen Zürich AG
0,20,186,14,7,227,Flughafen Zürich AG
0,12,137,4,14,167,Flughafen Zürich AG
0,10,160,26,2,198,Flughafen Zürich AG
0,13,126,83,1,223,Flughafen Zürich AG
0,27,211,17,10,265,Flughafen Zürich AG
0,32,172,64,7,275,Flughafen Zürich AG
140,21,32,58,8,259,Flughafen Zürich AG
111,22,83,18,4,238,Flughafen Zürich AG
0,21,160,11,5,197,Flughafen Zürich AG
0,18,178,17,8,221,Flughafen Zürich AG
0,21,213,19,3,256,Flughafen Zürich AG
0,29,231,20,4,284,Flughafen Zürich AG
0,46,155,66,4,271,Flughafen Zürich AG
0,25,181,61,11,278,Flughafen Zürich AG
0,27,185,29,8,249,Flughafen Zürich AG
0,17,168,10,5,200,Flughafen Zürich AG
0,17,160,15,7,199,Flughafen Zürich AG
0,21,206,16,4,247,Flughafen Zürich AG
0,22,236,17,13,288,Flughafen Zürich AG
0,10,94,170,6,280,Flughafen Zürich AG
0,3,92,2,10,107,Flughafen Zürich AG
0,3,104,4,5,116,Flughafen Zürich AG
0,6,103,29,11,149,Flughafen Zürich AG
0,3,142,8,14,167,Flughafen Zürich AG
0,5,102,35,17,159,Flughafen Zürich AG
0,9,139,17,17,182,Flughafen Zürich AG
0,4,125,5,8,142,Flughafen Zürich AG
0,2,101,4,10,117,Flughafen Zürich AG
0,2,100,4,8,114,Flughafen Zürich AG
0,10,145,6,6,167,Flughafen Zürich AG
0,12,158,9,6,185,Flughafen Zürich AG
0,11,70,59,17,157,Flughafen Zürich AG
0,15,133,23,10,181,Flughafen Zürich AG
0,5,127,5,8,145,Flughafen Zürich AG
0,2,95,2,9,108,Flughafen Zürich AG
0,5,106,6,4,121,Flughafen Zürich AG
0,8,152,7,4,171,Flughafen Zürich AG
0,14,165,23,1,203,Flughafen Zürich AG
33,24,77,43,7,184,Flughafen Zürich AG
15,14,91,69,11,200,Flughafen Zürich AG
0,9,139,10,5,163,Flughafen Zürich AG
0,3,101,5,9,118,Flughafen Zürich AG
0,3,104,8,5,120,Flughafen Zürich AG
0,10,125,46,7,188,Flughafen Zürich AG
0,10,200,9,6,225,Flughafen Zürich AG
0,23,118,43,2,186,Flughafen Zürich AG
0,13,152,28,6,199,Flughafen Zürich AG
0,12,119,33,3,167,Flughafen Zürich AG
0,4,91,18,8,121,Flughafen Zürich AG
0,0,8,117,18,143,Flughafen Zürich AG
0,11,71,18,14,114,Flughafen Zürich AG
0,6,51,49,10,116,Flughafen Zürich AG
0,3,72,2,8,85,Flughafen Zürich AG
0,0,34,27,8,69,Flughafen Zürich AG
0,0,3,82,6,91,Flughafen Zürich AG
0,3,57,21,19,100,Flughafen Zürich AG
0,0,6,102,33,141,Flughafen Zürich AG
0,11,83,16,16,126,Flughafen Zürich AG
0,2,91,10,17,120,Flughafen Zürich AG
0,0,16,75,9,100,Flughafen Zürich AG
0,1,56,19,13,89,Flughafen Zürich AG
0,8,104,5,4,121,Flughafen Zürich AG
0,0,16,84,25,125,Flughafen Zürich AG
0,6,66,32,15,119,Flughafen Zürich AG
0,3,58,34,22,117,Flughafen Zürich AG
0,5,127,12,13,157,Flughafen Zürich AG
0,0,2,95,20,117,Flughafen Zürich AG
0,0,2,69,18,89,Flughafen Zürich AG
0,0,36,58,3,97,Flughafen Zürich AG
0,4,102,4,13,123,Flughafen Zürich AG
0,10,149,7,12,178,Flughafen Zürich AG
0,0,5,135,10,150,Flughafen Zürich AG
0,2,85,15,17,119,Flughafen Zürich AG
0,1,105,16,17,139,Flughafen Zürich AG
0,1,9,75,14,99,Flughafen Zürich AG
0,0,15,69,11,95,Flughafen Zürich AG
0,2,98,5,12,117,Flughafen Zürich AG
0,11,135,6,8,160,Flughafen Zürich AG
66,17,27,15,18,143,Flughafen Zürich AG
130,6,0,17,14,167,Flughafen Zürich AG
0,10,112,5,4,131,Flughafen Zürich AG
0,13,115,2,8,138,Flughafen Zürich AG
5,3,65,33,19,125,Flughafen Zürich AG
65,7,0,12,17,101,Flughafen Zürich AG
34,1,33,12,11,91,Flughafen Zürich AG
0,0,12,72,18,102,Flughafen Zürich AG
0,0,49,31,5,85,Flughafen Zürich AG
0,0,1,58,11,70,Flughafen Zürich AG
0,9,82,2,6,99,Flughafen Zürich AG
0,3,99,14,6,122,Flughafen Zürich AG
0,11,69,27,7,114,Flughafen Zürich AG
0,4,67,52,11,134,Flughafen Zürich AG
0,5,75,4,3,87,Flughafen Zürich AG
12,0,49,1,7,69,Flughafen Zürich AG
53,0,20,1,7,81,Flughafen Zürich AG
55,2,22,4,10,93,Flughafen Zürich AG
98,4,12,7,6,127,Flughafen Zürich AG
71,2,0,13,21,107,Flughafen Zürich AG
0,8,56,44,11,119,Flughafen Zürich AG
0,4,74,6,10,94,Flughafen Zürich AG
0,8,62,1,3,74,Flughafen Zürich AG
0,1,44,23,10,78,Flughafen Zürich AG
0,6,66,12,10,94,Flughafen Zürich AG
71,6,35,5,13,130,Flughafen Zürich AG
0,10,78,18,17,123,Flughafen Zürich AG
12,11,69,14,8,114,Flughafen Zürich AG
23,2,49,2,12,88,Flughafen Zürich AG
0,2,50,1,7,60,Flughafen Zürich AG
0,2,61,13,7,83,Flughafen Zürich AG
0,4,64,16,14,98,Flughafen Zürich AG
0,2,83,18,18,121,Flughafen Zürich AG
0,1,57,1,7,66,Flughafen Zürich AG
0,5,49,1,2,57,Flughafen Zürich AG
0,2,60,1,5,68,Flughafen Zürich AG
0,3,53,13,12,81,Flughafen Zürich AG
0,5,72,3,8,88,Flughafen Zürich AG
31,3,15,10,15,74,Flughafen Zürich AG
0,2,64,10,11,87,Flughafen Zürich AG
27,4,40,2,5,78,Flughafen Zürich AG
0,1,44,2,10,57,Flughafen Zürich AG
0,5,58,2,6,71,Flughafen Zürich AG
0,0,8,54,13,75,Flughafen Zürich AG
0,0,4,70,11,85,Flughafen Zürich AG
0,0,22,37,9,68,Flughafen Zürich AG
0,0,55,19,11,85,Flughafen Zürich AG
0,4,39,24,7,74,Flughafen Zürich AG
0,0,13,34,9,56,Flughafen Zürich AG
0,1,52,2,10,65,Flughafen Zürich AG
0,4,73,7,7,91,Flughafen Zürich AG
0,5,75,23,3,106,Flughafen Zürich AG
42,6,19,7,12,86,Flughafen Zürich AG
0,3,64,15,10,92,Flughafen Zürich AG
0,1,68,2,7,78,Flughafen Zürich AG
14,2,40,3,3,62,Flughafen Zürich AG
0,5,71,2,4,82,Flughafen Zürich AG
0,8,59,21,8,96,Flughafen Zürich AG
0,4,100,7,5,116,Flughafen Zürich AG
0,0,11,59,42,112,Flughafen Zürich AG
0,9,81,9,11,110,Flughafen Zürich AG
0,4,82,1,8,95,Flughafen Zürich AG
0,2,62,4,7,75,Flughafen Zürich AG
0,3,75,2,9,89,Flughafen Zürich AG
0,7,47,2,5,61,Flughafen Zürich AG
0,0,34,10,8,52,Flughafen Zürich AG
0,8,42,7,4,61,Flughafen Zürich AG
0,4,59,6,6,75,Flughafen Zürich AG
0,4,74,3,3,84,Flughafen Zürich AG
0,11,46,3,9,69,Flughafen Zürich AG
0,1,30,20,28,79,Flughafen Zürich AG
0,3,38,12,7,60,Flughafen Zürich AG
0,3,37,3,5,48,Flughafen Zürich AG
0,7,30,9,6,52,Flughafen Zürich AG
27,4,15,15,9,70,Flughafen Zürich AG
62,1,25,7,4,99,Flughafen Zürich AG
59,7,0,12,8,86,Flughafen Zürich AG
0,3,56,6,7,72,Flughafen Zürich AG
0,2,61,2,4,69,Flughafen Zürich AG
0,1,47,3,5,56,Flughafen Zürich AG
0,2,44,2,5,53,Flughafen Zürich AG
0,2,66,5,6,79,Flughafen Zürich AG
0,5,78,2,6,91,Flughafen Zürich AG
0,1,75,6,10,92,Flughafen Zürich AG
0,4,76,6,6,92,Flughafen Zürich AG
0,4,60,2,3,69,Flughafen Zürich AG
0,1,43,2,4,50,Flughafen Zürich AG
0,5,58,3,3,69,Flughafen Zürich AG
0,7,51,3,5,66,Flughafen Zürich AG
0,2,78,5,4,89,Flughafen Zürich AG
77,5,0,10,5,97,Flughafen Zürich AG
30,1,37,9,11,88,Flughafen Zürich AG
0,4,45,8,7,64,Flughafen Zürich AG
0,3,90,10,17,120,Flughafen Zürich AG
0,2,121,21,11,155,Flughafen Zürich AG
60,1,39,2,5,107,Flughafen Zürich AG
0,0,69,1,4,74,Flughafen Zürich AG
0,3,67,14,5,89,Flughafen Zürich AG
0,5,81,4,6,96,Flughafen Zürich AG
0,6,87,4,7,104,Flughafen Zürich AG
28,1,52,5,15,101,Flughafen Zürich AG
104,3,0,11,9,127,Flughafen Zürich AG
0,3,81,3,7,94,Flughafen Zürich AG
0,11,35,5,6,57,Flughafen Zürich AG
0,3,58,4,6,71,Flughafen Zürich AG
0,22,55,13,2,92,Flughafen Zürich AG
0,23,67,2,8,100,Flughafen Zürich AG
0,9,63,1,9,82,Flughafen Zürich AG
0,2,60,13,9,84,Flughafen Zürich AG
0,1,69,1,9,80,Flughafen Zürich AG
0,6,46,1,5,58,Flughafen Zürich AG
0,3,57,2,3,65,Flughafen Zürich AG
4,4,34,14,13,69,Flughafen Zürich AG
0,4,70,3,6,83,Flughafen Zürich AG
0,11,45,6,5,67,Flughafen Zürich AG
0,3,51,25,7,86,Flughafen Zürich AG
0,7,56,4,1,68,Flughafen Zürich AG
0,0,25,20,7,52,Flughafen Zürich AG
0,3,40,11,1,55,Flughafen Zürich AG
0,8,36,24,6,74,Flughafen Zürich AG
0,0,3,70,17,90,Flughafen Zürich AG
0,6,49,8,8,71,Flughafen Zürich AG
0,4,61,12,9,86,Flughafen Zürich AG
0,3,40,7,2,52,Flughafen Zürich AG
0,3,65,3,5,76,Flughafen Zürich AG
0,8,82,4,5,99,Flughafen Zürich AG
0,2,94,3,5,104,Flughafen Zürich AG
0,9,62,9,9,89,Flughafen Zürich AG
0,5,73,3,8,89,Flughafen Zürich AG
0,7,75,2,7,91,Flughafen Zürich AG
0,3,58,0,8,69,Flughafen Zürich AG
0,4,69,4,1,78,Flughafen Zürich AG
0,6,75,2,9,92,Flughafen Zürich AG
0,1,109,3,8,121,Flughafen Zürich AG
0,9,67,4,9,89,Flughafen Zürich AG
0,6,84,11,6,107,Flughafen Zürich AG
0,4,76,1,5,86,Flughafen Zürich AG
0,5,65,1,10,81,Flughafen Zürich AG
0,4,87,1,5,97,Flughafen Zürich AG
0,11,105,2,9,127,Flughafen Zürich AG
0,10,151,1,1,163,Flughafen Zürich AG
0,11,143,5,7,166,Flughafen Zürich AG
0,3,121,15,9,148,Flughafen Zürich AG
0,11,101,4,4,120,Flughafen Zürich AG
0,2,56,30,7,95,Flughafen Zürich AG
0,5,97,8,4,114,Flughafen Zürich AG
0,0,23,48,12,83,Flughafen Zürich AG
0,1,62,13,8,84,Flughafen Zürich AG
0,10,85,15,4,114,Flughafen Zürich AG
0,5,85,22,5,117,Flughafen Zürich AG
0,5,95,7,3,110,Flughafen Zürich AG
0,0,28,41,3,72,Flughafen Zürich AG
0,3,90,2,3,98,Flughafen Zürich AG
0,1,52,0,7,60,Flughafen Zürich AG
0,4,102,12,9,127,Flughafen Zürich AG
0,3,90,3,7,103,Flughafen Zürich AG
0,0,37,23,10,70,Flughafen Zürich AG
0,4,67,4,3,78,Flughafen Zürich AG
0,7,80,2,9,98,Flughafen Zürich AG
0,0,104,2,6,112,Flughafen Zürich AG
0,6,73,4,18,101,Flughafen Zürich AG
0,5,76,7,11,99,Flughafen Zürich AG
0,4,77,1,5,87,Flughafen Zürich AG
0,2,54,1,5,62,Flughafen Zürich AG
0,1,64,3,7,75,Flughafen Zürich AG
0,8,82,5,6,101,Flughafen Zürich AG
0,1,92,1,9,103,Flughafen Zürich AG
0,6,64,10,10,90,Flughafen Zürich AG
0,7,76,8,6,97,Flughafen Zürich AG
0,4,69,10,6,89,Flughafen Zürich AG
0,0,59,2,7,68,Flughafen Zürich AG
0,2,65,2,3,72,Flughafen Zürich AG
0,6,51,22,10,89,Flughafen Zürich AG
0,2,93,4,7,106,Flughafen Zürich AG
0,1,57,7,17,82,Flughafen Zürich AG
0,1,70,6,7,84,Flughafen Zürich AG
0,1,61,1,8,71,Flughafen Zürich AG
0,2,56,2,6,66,Flughafen Zürich AG
0,2,59,5,4,70,Flughafen Zürich AG
0,0,69,0,9,78,Flughafen Zürich AG
0,3,98,2,4,107,Flughafen Zürich AG
0,1,56,11,12,80,Flughafen Zürich AG
0,1,69,11,7,88,Flughafen Zürich AG
0,4,88,1,7,100,Flughafen Zürich AG
0,7,103,21,4,135,Flughafen Zürich AG
45,14,89,8,8,164,Flughafen Zürich AG
0,19,70,57,18,164,Flughafen Zürich AG
0,5,87,67,8,167,Flughafen Zürich AG
0,2,40,88,5,135,Flughafen Zürich AG
0,2,43,53,2,100,Flughafen Zürich AG
0,1,57,58,13,129,Flughafen Zürich AG
0,5,111,4,4,124,Flughafen Zürich AG
0,7,151,10,3,171,Flughafen Zürich AG
0,11,99,39,13,162,Flughafen Zürich AG
0,6,130,33,10,179,Flughafen Zürich AG
0,6,118,2,7,133,Flughafen Zürich AG
0,6,92,1,5,104,Flughafen Zürich AG
54,4,50,7,5,120,Flughafen Zürich AG
0,10,99,5,5,119,Flughafen Zürich AG
0,7,146,8,7,168,Flughafen Zürich AG
0,10,106,30,13,159,Flughafen Zürich AG
0,3,115,22,14,154,Flughafen Zürich AG
0,2,105,5,8,120,Flughafen Zürich AG
0,2,75,5,4,86,Flughafen Zürich AG
0,2,80,6,3,91,Flughafen Zürich AG
0,5,68,26,11,110,Flughafen Zürich AG
0,4,123,3,7,137,Flughafen Zürich AG
0,8,87,27,12,134,Flughafen Zürich AG
0,3,92,12,12,119,Flughafen Zürich AG
0,0,80,26,5,111,Flughafen Zürich AG
0,6,72,3,3,84,Flughafen Zürich AG
0,2,82,5,2,91,Flughafen Zürich AG
0,3,43,58,9,113,Flughafen Zürich AG
0,3,81,38,4,126,Flughafen Zürich AG
0,7,91,0,13,111,Flughafen Zürich AG
0,5,118,5,5,133,Flughafen Zürich AG
0,2,113,6,8,129,Flughafen Zürich AG
0,7,137,7,5,156,Flughafen Zürich AG
0,4,161,10,10,185,Flughafen Zürich AG
0,10,94,42,22,168,Flughafen Zürich AG
0,6,123,26,18,173,Flughafen Zürich AG
101,2,40,11,4,158,Flughafen Zürich AG
0,5,101,5,5,116,Flughafen Zürich AG
0,1,120,10,5,136,Flughafen Zürich AG
33,10,82,11,4,140,Flughafen Zürich AG
0,8,161,7,8,184,Flughafen Zürich AG
0,11,113,25,15,164,Flughafen Zürich AG
0,7,128,36,7,178,Flughafen Zürich AG
0,2,121,9,8,140,Flughafen Zürich AG
0,7,102,2,4,115,Flughafen Zürich AG
0,2,132,8,2,144,Flughafen Zürich AG
75,2,41,4,12,134,Flughafen Zürich AG
0,7,147,7,10,171,Flughafen Zürich AG
0,10,104,30,16,160,Flughafen Zürich AG
9,6,126,28,6,175,Flughafen Zürich AG
0,3,108,13,6,130,Flughafen Zürich AG
0,6,115,6,4,131,Flughafen Zürich AG
0,1,113,6,8,128,Flughafen Zürich AG
0,7,106,10,7,130,Flughafen Zürich AG
0,9,140,21,7,177,Flughafen Zürich AG
0,1,0,138,13,152,Flughafen Zürich AG
0,6,105,51,12,174,Flughafen Zürich AG
0,9,115,12,4,140,Flughafen Zürich AG
0,5,104,7,2,118,Flughafen Zürich AG
0,2,119,3,8,132,Flughafen Zürich AG
0,18,125,41,9,193,Flughafen Zürich AG
0,7,109,55,15,186,Flughafen Zürich AG
0,4,148,10,5,167,Flughafen Zürich AG
0,5,118,3,5,131,Flughafen Zürich AG
79,3,57,6,6,151,Flughafen Zürich AG
0,8,142,11,5,166,Flughafen Zürich AG
0,10,160,11,7,188,Flughafen Zürich AG
0,20,128,49,8,205,Flughafen Zürich AG
0,12,129,32,13,186,Flughafen Zürich AG
0,5,145,10,9,169,Flughafen Zürich AG
0,7,112,3,3,125,Flughafen Zürich AG
0,4,132,5,5,146,Flughafen Zürich AG
0,10,133,12,3,158,Flughafen Zürich AG
0,8,157,11,4,180,Flughafen Zürich AG
0,18,127,29,22,196,Flughafen Zürich AG
0,9,138,33,13,193,Flughafen Zürich AG
0,5,148,10,5,168,Flughafen Zürich AG
0,4,94,18,2,118,Flughafen Zürich AG
0,1,126,6,7,140,Flughafen Zürich AG
0,9,128,3,6,146,Flughafen Zürich AG
0,6,165,10,1,182,Flughafen Zürich AG
0,8,100,29,41,178,Flughafen Zürich AG
0,0,7,143,20,170,Flughafen Zürich AG
0,0,54,86,11,151,Flughafen Zürich AG
0,6,102,4,3,115,Flughafen Zürich AG
0,0,0,123,13,136,Flughafen Zürich AG
0,6,136,7,4,153,Flughafen Zürich AG
0,4,85,90,8,187,Flughafen Zürich AG
0,12,111,28,15,166,Flughafen Zürich AG
0,3,104,48,14,169,Flughafen Zürich AG
0,4,145,6,7,162,Flughafen Zürich AG
0,13,77,35,5,130,Flughafen Zürich AG
0,3,48,72,7,130,Flughafen Zürich AG
0,4,138,8,8,158,Flughafen Zürich AG
0,9,78,28,20,135,Flughafen Zürich AG
0,2,55,66,17,140,Flughafen Zürich AG
0,0,24,74,31,129,Flughafen Zürich AG
0,8,101,4,9,122,Flughafen Zürich AG
0,2,61,68,4,135,Flughafen Zürich AG
0,11,118,9,3,141,Flughafen Zürich AG
0,6,89,73,3,171,Flughafen Zürich AG
0,14,90,47,6,157,Flughafen Zürich AG
80,8,23,23,15,149,Flughafen Zürich AG
0,7,123,14,4,148,Flughafen Zürich AG
0,7,95,8,4,114,Flughafen Zürich AG
0,3,85,48,7,143,Flughafen Zürich AG
0,11,89,42,11,153,Flughafen Zürich AG
0,6,144,12,1,163,Flughafen Zürich AG
65,18,30,36,18,167,Flughafen Zürich AG
0,10,107,32,13,162,Flughafen Zürich AG
0,6,129,13,6,154,Flughafen Zürich AG
0,8,104,4,5,121,Flughafen Zürich AG
0,5,126,10,7,148,Flughafen Zürich AG
0,12,98,41,7,158,Flughafen Zürich AG
0,8,123,21,7,159,Flughafen Zürich AG
0,15,114,39,13,181,Flughafen Zürich AG
0,3,95,47,21,166,Flughafen Zürich AG
0,5,136,11,3,155,Flughafen Zürich AG
0,1,71,46,4,122,Flughafen Zürich AG
0,4,127,8,5,144,Flughafen Zürich AG
0,7,120,8,9,144,Flughafen Zürich AG
0,13,158,13,1,185,Flughafen Zürich AG
0,2,38,4,2,46,Flughafen Zürich AG
13,2,16,1,7,39,Flughafen Zürich AG
0,3,28,11,5,47,Flughafen Zürich AG
0,3,48,4,3,58,Flughafen Zürich AG
0,2,22,45,9,78,Flughafen Zürich AG
0,0,3,36,8,47,Flughafen Zürich AG
0,3,54,4,6,67,Flughafen Zürich AG
24,4,36,4,5,73,Flughafen Zürich AG
0,2,31,2,6,41,Flughafen Zürich AG
0,0,42,3,4,49,Flughafen Zürich AG
0,2,34,3,10,49,Flughafen Zürich AG
0,3,55,1,4,63,Flughafen Zürich AG
12,9,23,6,10,60,Flughafen Zürich AG
0,7,53,2,6,68,Flughafen Zürich AG
0,5,84,5,1,95,Flughafen Zürich AG
4,2,41,2,7,56,Flughafen Zürich AG
0,1,66,1,5,73,Flughafen Zürich AG
0,2,62,5,6,75,Flughafen Zürich AG
0,4,93,2,3,102,Flughafen Zürich AG
0,10,51,20,5,86,Flughafen Zürich AG
0,5,73,9,6,93,Flughafen Zürich AG
0,3,86,3,7,99,Flughafen Zürich AG
33,0,26,0,6,65,Flughafen Zürich AG
43,5,28,3,2,81,Flughafen Zürich AG
0,4,77,5,5,91,Flughafen Zürich AG
0,2,69,31,5,107,Flughafen Zürich AG
0,9,60,8,9,86,Flughafen Zürich AG
0,1,55,22,13,91,Flughafen Zürich AG
0,1,80,17,4,102,Flughafen Zürich AG
0,1,67,3,6,77,Flughafen Zürich AG
0,0,8,14,8,30,Flughafen Zürich AG
0,2,8,7,5,22,Flughafen Zürich AG
0,1,21,2,10,34,Flughafen Zürich AG
0,2,19,8,3,32,Flughafen Zürich AG
0,0,17,0,0,17,Flughafen Zürich AG
0,2,19,1,5,27,Flughafen Zürich AG
0,3,30,2,1,36,Flughafen Zürich AG
0,0,34,1,8,43,Flughafen Zürich AG
0,2,21,6,5,34,Flughafen Zürich AG
0,1,20,6,6,33,Flughafen Zürich AG
0,0,13,12,10,35,Flughafen Zürich AG
23,0,2,0,5,30,Flughafen Zürich AG
0,2,26,2,5,35,Flughafen Zürich AG
30,2,1,4,7,44,Flughafen Zürich AG
1,1,33,0,9,44,Flughafen Zürich AG
0,4,22,3,5,34,Flughafen Zürich AG
0,6,23,2,9,40,Flughafen Zürich AG
0,1,25,3,5,34,Flughafen Zürich AG
14,3,7,1,7,32,Flughafen Zürich AG
31,5,13,2,3,54,Flughafen Zürich AG
0,3,30,4,7,44,Flughafen Zürich AG
0,1,26,0,3,30,Flughafen Zürich AG
0,0,13,5,7,25,Flughafen Zürich AG
0,3,22,20,3,48,Flughafen Zürich AG
0,3,40,1,6,50,Flughafen Zürich AG
0,1,37,3,7,48,Flughafen Zürich AG
18,5,21,0,2,46,Flughafen Zürich AG
1,2,31,4,1,39,Flughafen Zürich AG
40,1,2,1,8,52,Flughafen Zürich AG
24,2,4,7,6,43,Flughafen Zürich AG
19,1,1,2,10,33,Flughafen Zürich AG
0,1,31,3,3,38,Flughafen Zürich AG
0,2,18,6,0,26,Flughafen Zürich AG
0,1,29,2,2,34,Flughafen Zürich AG
0,4,16,2,4,26,Flughafen Zürich AG
8,3,17,3,1,32,Flughafen Zürich AG
0,2,17,2,2,23,Flughafen Zürich AG
9,2,10,0,1,22,Flughafen Zürich AG
0,5,27,1,0,33,Flughafen Zürich AG
0,2,19,1,0,22,Flughafen Zürich AG
0,1,13,3,6,23,Flughafen Zürich AG
1,1,11,3,3,19,Flughafen Zürich AG
0,2,17,2,5,26,Flughafen Zürich AG
0,0,15,4,6,25,Flughafen Zürich AG
6,1,2,0,1,10,Flughafen Zürich AG
0,0,19,0,4,23,Flughafen Zürich AG
0,1,27,1,0,29,Flughafen Zürich AG
0,3,25,0,5,33,Flughafen Zürich AG
0,1,15,2,7,25,Flughafen Zürich AG
8,3,2,3,7,23,Flughafen Zürich AG
11,0,3,2,3,19,Flughafen Zürich AG
20,1,2,1,2,26,Flughafen Zürich AG
10,1,10,0,1,22,Flughafen Zürich AG
0,0,23,2,6,31,Flughafen Zürich AG
0,0,14,17,4,35,Flughafen Zürich AG
0,1,15,2,3,21,Flughafen Zürich AG
0,3,16,1,6,26,Flughafen Zürich AG
0,0,14,6,5,25,Flughafen Zürich AG
0,3,19,0,2,24,Flughafen Zürich AG
0,1,9,13,5,28,Flughafen Zürich AG
0,3,13,3,4,23,Flughafen Zürich AG
0,36,184,101,6,327,Flughafen Zürich AG
0,29,202,86,6,323,Flughafen Zürich AG
0,26,254,22,4,306,Flughafen Zürich AG
0,30,262,25,4,321,Flughafen Zürich AG
0,30,175,119,6,330,Flughafen Zürich AG
0,0,0,331,6,337,Flughafen Zürich AG
0,10,78,178,8,274,Flughafen Zürich AG
0,29,216,62,4,311,Flughafen Zürich AG
0,10,134,129,6,279,Flughafen Zürich AG
0,23,179,14,2,218,Flughafen Zürich AG
0,13,134,86,6,239,Flughafen Zürich AG
0,7,79,165,5,256,Flughafen Zürich AG
0,0,0,248,21,269,Flughafen Zürich AG
0,13,102,103,5,223,Flughafen Zürich AG
0,17,156,58,2,233,Flughafen Zürich AG
0,17,149,9,2,177,Flughafen Zürich AG
0,10,129,10,3,152,Flughafen Zürich AG
0,10,99,7,2,118,Flughafen Zürich AG
0,8,95,5,1,109,Flughafen Zürich AG
0,11,98,9,5,123,Flughafen Zürich AG
27,9,15,15,11,77,Flughafen Zürich AG
47,9,0,17,7,80,Flughafen Zürich AG
28,5,3,0,6,42,Flughafen Zürich AG
21,0,6,1,6,34,Flughafen Zürich AG
28,1,5,0,6,40,Flughafen Zürich AG
17,3,21,2,2,45,Flughafen Zürich AG
0,4,44,1,3,52,Flughafen Zürich AG
0,1,16,1,5,23,Flughafen Zürich AG
0,0,25,4,11,40,Flughafen Zürich AG
27,0,3,0,4,34,Flughafen Zürich AG
22,2,2,0,3,29,Flughafen Zürich AG
0,33,113,120,8,274,Flughafen Zürich AG
0,5,14,274,17,310,Flughafen Zürich AG
0,0,0,329,9,338,Flughafen Zürich AG
0,0,0,299,5,304,Flughafen Zürich AG
0,5,103,203,4,315,Flughafen Zürich AG
0,28,271,29,3,331,Flughafen Zürich AG
0,34,284,24,2,344,Flughafen Zürich AG
0,35,173,73,5,286,Flughafen Zürich AG
0,25,100,147,6,278,Flughafen Zürich AG
0,0,21,218,3,242,Flughafen Zürich AG
0,0,0,291,5,296,Flughafen Zürich AG
0,0,0,308,5,313,Flughafen Zürich AG
0,24,162,120,4,310,Flughafen Zürich AG
0,30,276,42,3,351,Flughafen Zürich AG
0,36,193,59,4,292,Flughafen Zürich AG
0,35,210,71,3,319,Flughafen Zürich AG
0,15,180,126,3,324,Flughafen Zürich AG
0,10,144,132,7,293,Flughafen Zürich AG
0,0,25,296,7,328,Flughafen Zürich AG
0,31,263,33,5,332,Flughafen Zürich AG
0,29,292,25,3,349,Flughafen Zürich AG
0,37,185,77,4,303,Flughafen Zürich AG
0,8,39,265,8,320,Flughafen Zürich AG
0,29,216,88,2,335,Flughafen Zürich AG
0,7,87,216,7,317,Flughafen Zürich AG
0,3,31,278,7,319,Flughafen Zürich AG
0,26,192,117,2,337,Flughafen Zürich AG
0,31,298,28,3,360,Flughafen Zürich AG
0,43,160,84,4,291,Flughafen Zürich AG
0,31,212,33,7,283,Flughafen Zürich AG
0,31,265,30,5,331,Flughafen Zürich AG
0,37,270,25,6,338,Flughafen Zürich AG
0,33,194,67,3,297,Flughafen Zürich AG
0,32,229,82,4,347,Flughafen Zürich AG
0,39,274,12,4,329,Flughafen Zürich AG
0,32,246,20,2,300,Flughafen Zürich AG
0,32,262,22,4,320,Flughafen Zürich AG
0,29,262,30,4,325,Flughafen Zürich AG
0,34,286,22,5,347,Flughafen Zürich AG
0,34,170,65,4,273,Flughafen Zürich AG
0,34,243,38,2,317,Flughafen Zürich AG
0,34,256,24,1,315,Flughafen Zürich AG
0,30,242,20,4,296,Flughafen Zürich AG
0,30,269,23,5,327,Flughafen Zürich AG
0,27,273,26,2,328,Flughafen Zürich AG
0,33,287,26,3,349,Flughafen Zürich AG
0,18,121,129,7,275,Flughafen Zürich AG
0,32,229,84,3,348,Flughafen Zürich AG
249,34,43,40,2,368,Flughafen Zürich AG
0,32,271,20,1,324,Flughafen Zürich AG
1,32,271,29,9,342,Flughafen Zürich AG
3,34,298,38,4,377,Flughafen Zürich AG
0,39,354,23,2,418,Flughafen Zürich AG
0,40,224,12,5,281,Flughafen Zürich AG
0,32,241,41,3,317,Flughafen Zürich AG
0,37,259,20,4,320,Flughafen Zürich AG
0,0,0,281,8,289,Flughafen Zürich AG
0,30,190,90,6,316,Flughafen Zürich AG
0,31,258,22,6,317,Flughafen Zürich AG
0,33,273,26,4,336,Flughafen Zürich AG
0,32,218,79,4,333,Flughafen Zürich AG
0,29,273,29,3,334,Flughafen Zürich AG
0,32,251,21,2,306,Flughafen Zürich AG
0,27,282,26,4,339,Flughafen Zürich AG
0,31,266,28,5,330,Flughafen Zürich AG
0,37,276,28,5,346,Flughafen Zürich AG
0,12,102,142,10,266,Flughafen Zürich AG
0,31,207,77,6,321,Flughafen Zürich AG
0,1,0,340,14,355,Flughafen Zürich AG
0,34,249,26,1,310,Flughafen Zürich AG
0,29,285,28,6,348,Flughafen Zürich AG
0,36,268,29,5,338,Flughafen Zürich AG
0,10,78,247,15,350,Flughafen Zürich AG
0,4,39,224,15,282,Flughafen Zürich AG
0,16,102,193,15,326,Flughafen Zürich AG
0,36,276,27,3,342,Flughafen Zürich AG
0,41,245,23,3,312,Flughafen Zürich AG
0,40,267,30,2,339,Flughafen Zürich AG
0,44,265,28,11,348,Flughafen Zürich AG
0,46,185,138,10,379,Flughafen Zürich AG
0,50,184,81,4,319,Flughafen Zürich AG
0,15,44,252,22,333,Flughafen Zürich AG
0,6,99,220,12,337,Flughafen Zürich AG
0,37,206,22,2,267,Flughafen Zürich AG
0,0,0,240,20,260,Flughafen Zürich AG
0,36,225,57,7,325,Flughafen Zürich AG
0,42,277,26,4,349,Flughafen Zürich AG
0,44,175,63,4,286,Flughafen Zürich AG
0,38,197,75,5,315,Flughafen Zürich AG
0,37,250,25,2,314,Flughafen Zürich AG
0,29,225,8,2,264,Flughafen Zürich AG
0,47,263,31,11,352,Flughafen Zürich AG
0,45,175,55,7,282,Flughafen Zürich AG
0,32,149,133,10,324,Flughafen Zürich AG
0,34,159,142,7,342,Flughafen Zürich AG
0,42,257,20,6,325,Flughafen Zürich AG
0,36,273,25,9,343,Flughafen Zürich AG
0,48,245,30,5,328,Flughafen Zürich AG
0,49,276,29,7,361,Flughafen Zürich AG
0,46,172,51,11,280,Flughafen Zürich AG
0,37,238,62,6,343,Flughafen Zürich AG
0,35,270,27,4,336,Flughafen Zürich AG
0,34,242,20,6,302,Flughafen Zürich AG
0,32,266,27,4,329,Flughafen Zürich AG
0,37,258,28,6,329,Flughafen Zürich AG
0,47,279,31,3,360,Flughafen Zürich AG
0,40,181,46,5,272,Flughafen Zürich AG
0,36,215,76,4,331,Flughafen Zürich AG
0,34,279,23,5,341,Flughafen Zürich AG
0,33,259,22,2,316,Flughafen Zürich AG
0,35,277,22,8,342,Flughafen Zürich AG
0,39,273,25,4,341,Flughafen Zürich AG
0,43,296,11,8,358,Flughafen Zürich AG
0,39,166,60,5,270,Flughafen Zürich AG
0,30,219,74,7,330,Flughafen Zürich AG
0,36,262,30,3,331,Flughafen Zürich AG
0,29,269,8,6,312,Flughafen Zürich AG
0,39,254,26,8,327,Flughafen Zürich AG
0,0,35,291,13,339,Flughafen Zürich AG
0,31,235,78,6,350,Flughafen Zürich AG
0,35,159,63,5,262,Flughafen Zürich AG
0,36,205,124,9,374,Flughafen Zürich AG
0,40,192,163,5,400,Flughafen Zürich AG
0,36,240,111,5,392,Flughafen Zürich AG
0,40,220,154,5,419,Flughafen Zürich AG
0,48,222,101,5,376,Flughafen Zürich AG
0,50,235,107,7,399,Flughafen Zürich AG
0,44,307,43,3,397,Flughafen Zürich AG
0,41,283,43,5,372,Flughafen Zürich AG
0,43,317,44,5,409,Flughafen Zürich AG
0,12,137,235,14,398,Flughafen Zürich AG
0,43,324,45,6,418,Flughafen Zürich AG
0,46,222,88,5,361,Flughafen Zürich AG
0,48,241,104,4,397,Flughafen Zürich AG
0,40,313,30,15,398,Flughafen Zürich AG
0,14,146,163,22,345,Flughafen Zürich AG
0,35,291,43,11,380,Flughafen Zürich AG
0,40,300,46,7,393,Flughafen Zürich AG
0,44,282,71,6,403,Flughafen Zürich AG
0,50,219,92,10,371,Flughafen Zürich AG
0,42,289,51,16,398,Flughafen Zürich AG
0,36,312,45,6,399,Flughafen Zürich AG
0,33,298,33,8,372,Flughafen Zürich AG
0,37,293,46,5,381,Flughafen Zürich AG
0,38,304,44,7,393,Flughafen Zürich AG
0,42,306,41,11,400,Flughafen Zürich AG
0,40,258,32,18,348,Flughafen Zürich AG
0,33,225,91,5,354,Flughafen Zürich AG
0,38,277,29,5,349,Flughafen Zürich AG
0,36,257,24,2,319,Flughafen Zürich AG
0,37,276,33,6,352,Flughafen Zürich AG
0,43,272,32,6,353,Flughafen Zürich AG
0,50,236,106,4,396,Flughafen Zürich AG
0,51,308,46,1,406,Flughafen Zürich AG
0,40,305,37,11,393,Flughafen Zürich AG
0,38,324,53,4,419,Flughafen Zürich AG
0,38,318,49,3,408,Flughafen Zürich AG
0,51,303,50,5,409,Flughafen Zürich AG
0,42,212,96,5,355,Flughafen Zürich AG
0,46,247,109,4,406,Flughafen Zürich AG
0,37,322,38,6,403,Flughafen Zürich AG
0,41,288,47,5,381,Flughafen Zürich AG
0,37,324,46,9,416,Flughafen Zürich AG
0,35,326,47,4,412,Flughafen Zürich AG
0,46,321,43,9,419,Flughafen Zürich AG
0,53,218,86,4,361,Flughafen Zürich AG
0,45,290,62,8,405,Flughafen Zürich AG
0,36,324,36,12,408,Flughafen Zürich AG
0,33,298,48,4,383,Flughafen Zürich AG
98,41,212,49,2,402,Flughafen Zürich AG
194,37,119,59,5,414,Flughafen Zürich AG
0,50,311,42,6,409,Flughafen Zürich AG
0,49,212,91,7,359,Flughafen Zürich AG
0,50,243,110,4,407,Flughafen Zürich AG
0,47,308,45,4,404,Flughafen Zürich AG
0,46,291,35,8,380,Flughafen Zürich AG
0,38,168,189,9,404,Flughafen Zürich AG
0,40,308,46,5,399,Flughafen Zürich AG
0,36,172,196,9,413,Flughafen Zürich AG
0,35,173,155,5,368,Flughafen Zürich AG
0,47,243,105,6,401,Flughafen Zürich AG
0,4,54,329,7,394,Flughafen Zürich AG
0,58,298,24,8,388,Flughafen Zürich AG
0,45,294,52,4,395,Flughafen Zürich AG
0,24,177,164,12,377,Flughafen Zürich AG
0,50,251,103,9,413,Flughafen Zürich AG
0,47,306,45,4,402,Flughafen Zürich AG
0,50,272,50,4,376,Flughafen Zürich AG
0,51,279,48,7,385,Flughafen Zürich AG
0,43,299,49,5,396,Flughafen Zürich AG
0,49,295,53,4,401,Flughafen Zürich AG
0,52,230,94,7,383,Flughafen Zürich AG
10,52,200,131,7,400,Flughafen Zürich AG
0,43,306,46,2,397,Flughafen Zürich AG
0,35,298,43,8,384,Flughafen Zürich AG
0,45,306,44,7,402,Flughafen Zürich AG
0,44,232,112,6,394,Flughafen Zürich AG
0,43,317,44,6,410,Flughafen Zürich AG
0,51,234,93,6,384,Flughafen Zürich AG
0,43,169,192,10,414,Flughafen Zürich AG
0,45,333,24,6,408,Flughafen Zürich AG
0,42,294,40,5,381,Flughafen Zürich AG
169,44,133,43,10,399,Flughafen Zürich AG
0,43,291,51,4,389,Flughafen Zürich AG
0,55,314,50,2,421,Flughafen Zürich AG
0,50,266,55,4,375,Flughafen Zürich AG
0,58,238,101,6,403,Flughafen Zürich AG
0,47,302,49,3,401,Flughafen Zürich AG
0,51,276,46,6,379,Flughafen Zürich AG
0,52,308,49,4,413,Flughafen Zürich AG
54,50,242,48,5,399,Flughafen Zürich AG
0,54,312,50,2,418,Flughafen Zürich AG
0,59,216,88,5,368,Flughafen Zürich AG
0,52,299,49,3,403,Flughafen Zürich AG
0,43,312,46,5,406,Flughafen Zürich AG
0,53,302,48,6,409,Flughafen Zürich AG
0,50,313,51,4,418,Flughafen Zürich AG
0,46,341,46,4,437,Flughafen Zürich AG
0,59,207,108,6,380,Flughafen Zürich AG
0,28,100,246,13,387,Flughafen Zürich AG
0,57,299,50,5,411,Flughafen Zürich AG
0,52,297,46,7,402,Flughafen Zürich AG
0,54,311,49,5,419,Flughafen Zürich AG
0,46,310,52,6,414,Flughafen Zürich AG
0,57,279,78,3,417,Flughafen Zürich AG
0,54,240,98,6,398,Flughafen Zürich AG
0,53,177,186,8,424,Flughafen Zürich AG
0,64,286,47,7,404,Flughafen Zürich AG
0,52,288,44,5,389,Flughafen Zürich AG
0,49,305,46,7,407,Flughafen Zürich AG
0,45,314,51,5,415,Flughafen Zürich AG
0,56,316,45,5,422,Flughafen Zürich AG
0,50,132,183,12,377,Flughafen Zürich AG
0,57,230,106,4,397,Flughafen Zürich AG
0,57,305,47,2,411,Flughafen Zürich AG
0,62,278,43,5,388,Flughafen Zürich AG
0,56,311,45,7,419,Flughafen Zürich AG
0,75,282,43,7,407,Flughafen Zürich AG
0,70,277,54,7,408,Flughafen Zürich AG
0,65,231,77,11,384,Flughafen Zürich AG
0,18,66,308,9,401,Flughafen Zürich AG
0,60,300,42,5,407,Flughafen Zürich AG
0,44,269,66,7,386,Flughafen Zürich AG
0,51,303,50,5,409,Flughafen Zürich AG
0,47,222,92,4,365,Flughafen Zürich AG
0,46,247,109,4,406,Flughafen Zürich AG
0,32,287,82,2,403,Flughafen Zürich AG
0,44,297,34,7,382,Flughafen Zürich AG
67,58,247,35,8,415,Flughafen Zürich AG
0,8,127,253,4,392,Flughafen Zürich AG
0,42,228,155,4,429,Flughafen Zürich AG
0,54,217,88,7,366,Flughafen Zürich AG
0,52,238,102,3,395,Flughafen Zürich AG
0,50,273,52,14,389,Flughafen Zürich AG
0,38,309,52,6,405,Flughafen Zürich AG
0,36,335,47,5,423,Flughafen Zürich AG
0,42,321,47,4,414,Flughafen Zürich AG
73,48,241,50,6,418,Flughafen Zürich AG
0,5,51,303,12,371,Flughafen Zürich AG
0,44,255,102,5,406,Flughafen Zürich AG
0,52,314,42,6,414,Flughafen Zürich AG
0,52,311,20,11,394,Flughafen Zürich AG
0,48,316,54,2,420,Flughafen Zürich AG
0,54,222,116,10,402,Flughafen Zürich AG
0,47,313,47,7,414,Flughafen Zürich AG
0,48,223,90,8,369,Flughafen Zürich AG
0,47,286,50,18,401,Flughafen Zürich AG
0,51,300,55,6,412,Flughafen Zürich AG
0,42,303,41,7,393,Flughafen Zürich AG
0,54,303,51,8,416,Flughafen Zürich AG
0,15,101,270,14,400,Flughafen Zürich AG
0,58,297,50,8,413,Flughafen Zürich AG
27,70,174,99,9,379,Flughafen Zürich AG
0,52,232,118,8,410,Flughafen Zürich AG
0,44,270,43,17,374,Flughafen Zürich AG
0,26,168,178,6,378,Flughafen Zürich AG
0,38,307,43,5,393,Flughafen Zürich AG
0,8,57,279,13,357,Flughafen Zürich AG
0,31,128,211,5,375,Flughafen Zürich AG
0,32,316,42,1,391,Flughafen Zürich AG
0,29,312,44,4,389,Flughafen Zürich AG
0,37,281,65,7,390,Flughafen Zürich AG
0,4,64,304,9,381,Flughafen Zürich AG
0,38,322,40,5,405,Flughafen Zürich AG
0,12,64,274,13,363,Flughafen Zürich AG
39,38,187,108,7,379,Flughafen Zürich AG
241,36,58,55,4,394,Flughafen Zürich AG
216,25,85,46,7,379,Flughafen Zürich AG
250,35,53,51,5,394,Flughafen Zürich AG
0,40,308,49,9,406,Flughafen Zürich AG
0,45,309,47,9,410,Flughafen Zürich AG
0,43,212,83,13,351,Flughafen Zürich AG
0,40,238,103,5,386,Flughafen Zürich AG
0,45,301,44,3,393,Flughafen Zürich AG
0,8,119,238,9,374,Flughafen Zürich AG
0,33,301,45,8,387,Flughafen Zürich AG
0,41,305,43,12,401,Flughafen Zürich AG
0,46,312,46,5,409,Flughafen Zürich AG
0,54,193,109,5,361,Flughafen Zürich AG
0,40,236,103,3,382,Flughafen Zürich AG
0,44,315,40,8,407,Flughafen Zürich AG
0,35,270,61,8,374,Flughafen Zürich AG
0,39,300,61,8,408,Flughafen Zürich AG
0,42,291,41,14,388,Flughafen Zürich AG
0,43,303,45,7,398,Flughafen Zürich AG
0,39,294,35,9,377,Flughafen Zürich AG
0,34,306,28,4,372,Flughafen Zürich AG
0,30,180,154,10,374,Flughafen Zürich AG
0,41,284,44,7,376,Flughafen Zürich AG
87,50,212,40,6,395,Flughafen Zürich AG
0,43,204,99,9,355,Flughafen Zürich AG
0,34,131,201,11,377,Flughafen Zürich AG
0,32,300,41,14,387,Flughafen Zürich AG
0,42,293,46,2,383,Flughafen Zürich AG
0,47,282,41,8,378,Flughafen Zürich AG
63,47,221,49,6,386,Flughafen Zürich AG
0,50,304,40,7,401,Flughafen Zürich AG
0,34,140,177,7,358,Flughafen Zürich AG
0,39,229,102,7,377,Flughafen Zürich AG
161,44,139,39,6,389,Flughafen Zürich AG
0,43,283,38,6,370,Flughafen Zürich AG
0,49,288,45,6,388,Flughafen Zürich AG
0,54,310,47,6,417,Flughafen Zürich AG
0,49,244,94,8,395,Flughafen Zürich AG
81,45,131,87,5,349,Flughafen Zürich AG
0,44,221,92,7,364,Flughafen Zürich AG
0,52,238,85,4,379,Flughafen Zürich AG
0,53,266,41,8,368,Flughafen Zürich AG
35,39,180,106,10,370,Flughafen Zürich AG
165,47,114,57,8,391,Flughafen Zürich AG
0,38,304,48,3,393,Flughafen Zürich AG
0,30,116,202,11,359,Flughafen Zürich AG
0,19,182,172,8,381,Flughafen Zürich AG
0,33,302,42,4,381,Flughafen Zürich AG
0,33,287,35,11,366,Flughafen Zürich AG
0,0,0,357,11,368,Flughafen Zürich AG
0,38,186,73,6,303,Flughafen Zürich AG
0,21,144,167,10,342,Flughafen Zürich AG
0,15,77,248,8,348,Flughafen Zürich AG
0,0,0,314,6,320,Flughafen Zürich AG
0,36,277,34,3,350,Flughafen Zürich AG
0,20,104,227,6,357,Flughafen Zürich AG
0,36,297,34,3,370,Flughafen Zürich AG
0,0,0,288,16,304,Flughafen Zürich AG
0,0,3,339,8,350,Flughafen Zürich AG
0,0,0,337,10,347,Flughafen Zürich AG
0,36,260,29,1,326,Flughafen Zürich AG
0,0,0,338,10,348,Flughafen Zürich AG
0,0,60,293,11,364,Flughafen Zürich AG
0,1,14,333,17,365,Flughafen Zürich AG
0,6,36,243,17,302,Flughafen Zürich AG
0,6,33,292,18,349,Flughafen Zürich AG
0,33,293,32,8,366,Flughafen Zürich AG
0,35,274,24,4,337,Flughafen Zürich AG
134,33,153,36,3,359,Flughafen Zürich AG
0,42,279,30,8,359,Flughafen Zürich AG
0,38,289,35,3,365,Flughafen Zürich AG
0,41,169,83,11,304,Flughafen Zürich AG
0,34,114,191,6,345,Flughafen Zürich AG
0,1,100,249,10,360,Flughafen Zürich AG
0,38,277,31,3,349,Flughafen Zürich AG
168,38,107,40,4,357,Flughafen Zürich AG
190,35,86,39,6,356,Flughafen Zürich AG
0,39,304,29,8,380,Flughafen Zürich AG
0,45,167,89,6,307,Flughafen Zürich AG
100,45,104,99,10,358,Flughafen Zürich AG
0,35,272,39,5,351,Flughafen Zürich AG
0,46,217,9,10,282,Flughafen Zürich AG
0,32,195,91,10,328,Flughafen Zürich AG
0,37,254,29,3,323,Flughafen Zürich AG
0,29,268,26,2,325,Flughafen Zürich AG
0,31,277,33,4,345,Flughafen Zürich AG
0,36,273,30,5,344,Flughafen Zürich AG
0,38,291,28,4,361,Flughafen Zürich AG
0,5,59,218,16,298,Flughafen Zürich AG
0,32,101,197,7,337,Flughafen Zürich AG
0,34,269,34,3,340,Flughafen Zürich AG
0,31,264,24,3,322,Flughafen Zürich AG
0,30,287,28,6,351,Flughafen Zürich AG
0,33,291,32,4,360,Flughafen Zürich AG
0,32,297,33,2,364,Flughafen Zürich AG
0,34,187,84,4,309,Flughafen Zürich AG
0,32,220,92,5,349,Flughafen Zürich AG
0,31,277,28,4,340,Flughafen Zürich AG
0,31,276,26,3,336,Flughafen Zürich AG
0,32,282,35,5,354,Flughafen Zürich AG
0,30,303,32,4,369,Flughafen Zürich AG
85,36,214,40,5,380,Flughafen Zürich AG
148,43,35,85,6,317,Flughafen Zürich AG
0,37,219,88,10,354,Flughafen Zürich AG
39,32,244,32,4,351,Flughafen Zürich AG
0,31,269,28,2,330,Flughafen Zürich AG
0,39,291,38,2,370,Flughafen Zürich AG
0,27,159,173,5,364,Flughafen Zürich AG
0,33,181,77,3,294,Flughafen Zürich AG
0,0,16,323,14,353,Flughafen Zürich AG
0,27,264,42,3,336,Flughafen Zürich AG
0,30,287,39,2,358,Flughafen Zürich AG
0,40,195,77,5,317,Flughafen Zürich AG
0,33,228,88,6,355,Flughafen Zürich AG
0,30,282,34,2,348,Flughafen Zürich AG
0,34,242,38,6,320,Flughafen Zürich AG
0,16,183,132,10,341,Flughafen Zürich AG
0,40,243,32,4,319,Flughafen Zürich AG
0,33,272,39,4,348,Flughafen Zürich AG
0,35,177,75,6,293,Flughafen Zürich AG
0,2,0,329,8,339,Flughafen Zürich AG
0,4,79,244,12,339,Flughafen Zürich AG
0,36,258,27,4,325,Flughafen Zürich AG
0,30,280,31,6,347,Flughafen Zürich AG
0,9,101,228,9,347,Flughafen Zürich AG
0,30,312,29,3,374,Flughafen Zürich AG
0,30,185,78,5,298,Flughafen Zürich AG
0,33,229,90,3,355,Flughafen Zürich AG
0,31,322,32,1,386,Flughafen Zürich AG
0,31,276,29,3,339,Flughafen Zürich AG
0,31,285,36,5,357,Flughafen Zürich AG
0,34,196,159,5,394,Flughafen Zürich AG
0,40,369,34,4,447,Flughafen Zürich AG
0,41,224,26,9,300,Flughafen Zürich AG
0,36,183,111,6,336,Flughafen Zürich AG
0,34,272,33,4,343,Flughafen Zürich AG
0,33,257,26,2,318,Flughafen Zürich AG
0,31,266,36,3,336,Flughafen Zürich AG
0,40,275,32,6,353,Flughafen Zürich AG
